5 5 5 5 5 5 5 5 5 5 5 5 5 5 5
4 4 4 4 4 4 4 4 4 4 4 4 4 4 4
0 0 0 0 0 0 0 0 0 0 0 0 0 0 0
0 0 0 0 0 0 0 0 0 0 0 0 0 0 0	 
0 0 0 0 0 0 0 0 0 0 0 0 0 0 0	 
0 0 0 0 0 0 0 0 0 0 0 0 0 0 0	 
0 0 0 0 0 0 0 0 0 0 0 0 0 0 0	 
0 0 0 0 0 0 0 0 0 0 0 0 0 0 0